

      GG GG  GGG GGG GGGK
WWWWWWWWWWW  WWWWWWWWWWWWW
    R
  E R              GGGGGGG
      GGGGGG      WWWWWWWW
WWWWWWWWWWWWW         R  Q 
            R           G
 T         GGGGB     WWWWW
   U GG G WWWWWW   GGSSSSS
WWWWWWW   R       WWWSSTSS
SSSSSSSYGG     GGYSSSSSSSS
SSSSSSSWWWWW  WWWWWWWWWWWW
SSSSSSSSSSSS  SSSSSSSSSSSS