

      GG GG  GGG GG GGGK
WWWWRWWWWWWW  WWWWWWWWWWWWW
    R
  E                GGGGGGG
      GGGGGG      WWWWRWWW
WWWWWWWWWWWWR            Q 
                        G
 T         GGGGB     WWWWW
   U GG G RWWWWW   GGSSSSS
WWWWWWW           WWWSSTSS
SSSSSSSYGG     GGYSSSSSSSS
SSSSSSSWWWWW  WWWWWWWWWWWW
SSSSSSSSSSSS  SSSSSSSSSSSS