

      GG GG  GGG GGG GGGK
WWWWWWWWWWW  WWWWWWWWWWWWW
    R
  E                GGGGGGG
      GGGGGG      WWWWRWWW
WWWWWWWWWWWWR            Q 
                        G
 T         GGGGB     WWWWW
   U GG G RWWWW   GGSSSSS
WWWWWWW           WWWSSTSS
SSSSSSSYGG     GGYSSSSSSSS
SSSSSSSWWWWW  WWWWWWWWWWWW
SSSSSSSSSSSS  SSSSSSSSSSSS