

      GGGGGGGGGGGGGGGGGGK
WWWWWWWWWWWWWWWWWWWWWWWWWW
    R
  E R              GGGGGGG
      GGGGGG      WWWWWWWW
WWWWWWWWWWWWW         R  Q 
                        G
 T         GGGGG     WWWWW
   U GG G WWWWWWW  GGSSSSS
WWWWWWW   R       WWWSSTSS
SSSSSSS GG     GG SSSSSSSS
SSSSSSSWWWWW  WWWWWWWWWWWW
SSSSSSSSSSSS  SSSSSSSSSSSS